20 20
####################
#..................#
#..................#
#..................#
#..................#
#..................#
#..................#
#..................#
#.....g............#
#....#d#...........#
#....#d#..###......#
######d####s#......#
##ss##.#...x#......#
#s.....#xxx.#......#
##...#......#......#
#.......#####......#
#..................#
#..p.x.............#
#..................#
####################
18 5 20 6
15 2 13 7
14 3 12 7
14 4 11 7
13 12 17 8
