################
#......##......#
#.g....##......#
#......##......#
#......##......#
#......##......#
#......##.p....#
#......##......#
#......##......#
#......##......#
#......##......#
#..g...##......#
#......##......#
#......##......#
#......g.......#
################
