20 20
####################
#..................#
#..................#
#..................#
#..................#
#..................#
#..................#
#..................#
#.....g............#
#..g.#d#...........#
#....#d#..###......#
######d####s#......#
##ss##.#...x#......#
#s.....#xxx.#......#
##.g.#......#......#
#g......#####......#
#.  ....b.b.b......#
#..p.x...b.b.b.....#
#.......b.b.b......#
####################
18 5 20 6
15 2 13 7
14 3 12 7
14 4 11 7
13 12 17 8
